NO assets/textures/NO.xpm
SO assets/textures/SO.xpm
EA assets/textures/EA.xpm
WE assets/textures/WE.xpm

F 51, 47, 44  
C 119, 119, 119

1111111111111111111
11000000000000000001
10010000100010000001
1000000010N010000001
1111111111111111111